s594
W,W,W,W,W,W,W,W,W,W,W,W,W,W,W,W,W,W,W,W,W,W,W,W,W,
W,C,C,C,C,C,C,W,C,C,C,C,G,W,W,W,W,W,W,W,W,W,W,W,W,
W,C,C,C,C,C,C,C,C,C,C,W,W,W,W,W,W,W,W,W,W,W,W,W,W,
W,C,C,C,C,C,C,C,C,W,C,W,W,W,W,W,W,W,W,W,W,W,W,W,W,
W,C,C,W,F,C,C,C,C,C,C,C,W,W,W,W,W,W,W,W,W,W,W,W,W,
W,C,W,C,C,C,C,C,W,C,C,C,C,W,W,W,W,W,W,W,W,W,W,W,W,
W,C,C,C,C,C,C,W,C,C,C,C,C,W,W,W,W,W,W,W,W,W,W,W,W,
W,C,C,C,C,C,C,C,C,C,C,C,C,C,C,W,C,C,C,C,C,C,W,W,W,
W,C,C,C,C,F,C,C,C,C,C,C,C,C,C,C,C,C,W,C,C,C,W,W,W,
W,C,C,F,C,C,C,C,C,C,C,W,C,C,C,W,C,C,C,C,C,C,W,W,W,
W,C,C,C,C,C,C,C,C,C,W,C,C,C,C,C,C,W,C,C,C,W,W,W,W,
W,C,C,C,C,C,F,C,C,C,C,C,C,W,C,C,W,C,C,C,C,C,W,W,W,
W,C,C,C,C,C,C,C,C,C,C,C,W,C,C,C,C,C,C,W,C,C,W,W,W,
W,C,W,C,C,C,C,C,C,C,C,C,C,C,C,C,C,C,C,C,C,C,W,W,W,
W,C,C,W,C,C,C,C,C,C,C,C,C,C,C,C,C,C,C,C,C,C,W,W,W,
W,C,C,C,C,C,C,C,C,C,C,C,C,C,C,C,C,C,C,C,W,C,W,W,W,
W,C,C,C,C,C,C,C,C,C,C,C,C,C,W,F,C,C,C,C,C,C,W,W,W,
W,C,C,C,C,C,C,W,C,C,C,C,C,C,C,C,C,C,C,W,C,C,W,W,W,
W,C,C,C,C,C,C,C,C,C,C,C,C,C,C,C,C,C,C,C,C,C,W,W,W,
W,C,C,C,C,C,C,C,C,C,C,C,F,C,C,C,C,C,C,C,C,C,W,W,W,
W,C,C,C,C,W,C,C,C,C,C,C,W,C,C,C,C,C,H,C,C,C,W,W,W,
W,W,C,C,C,C,C,C,C,C,W,C,C,C,C,C,C,W,C,C,C,C,W,W,W,
W,C,C,C,C,C,C,C,C,C,C,C,C,C,C,W,C,C,C,F,F,F,W,W,W,
W,C,C,C,C,C,C,C,C,C,C,C,W,C,C,C,C,C,C,S,F,F,W,W,W,
W,W,W,W,W,W,W,W,W,W,W,W,W,W,W,W,W,W,W,W,W,W,W,W,W,